111111
1E0001
100C01
10PC01
111111