NO ./imgs/wall_2.pngk
SO ./imgs/west.png
EA ./imgs/east.pngk
WE ./imgs/west.pngk

C 225,30,0
F 220,110,0



        1111111111111111111111111
        1000000000110001000000001
        101100000111000N100000201
        10010000000O0000000020001
111111111011000001110000000000001
100000000011000001110111111111111
11110111111111011100000010001
11110111111111011101010010001
11000000110101011100000010001
10000000000000001100000010001
100000000000000DD1101010010001
1100000111010101111101111000111
11110111 1110101 101111010001
11111111 1111111 11111111111
