NO ./imgs/north.pngg
SO ./imgs/butterfly.pngf
WE ./imgs/west.png
EA ./imgs/east.p

C 225,30,0
F 220,110,0

        1111111111111111111111111
        1000000000110000000000001
        101100000111000E000000001
        1001000000000000000000001
111111111011000001110000000000001
100000000011000001110111111111111
11110111111111011100000010001
11110111111111011101010010001
11011100110101011100000010001
1001 100000000001100000010001
10011100000000011101010010001
1100000111010101 11101111000111
11110111 1110101 101111010001
11111111 1111111 11111111111
