NO ./path_to_the_north_texture
SO ./path_to_the_south_texture
WE ./path_to_the_west_texture
EA ./path_to_the_east_texture

C 225,30,0
F 220,110,0

 111111
10000S1
10111011
101 101
1011101
1000001
111111 